24 13
BBBBBBBBBBBBBBBBBBBBBBBB
BPPPPPPPPPPPPPPPPPPPPPPB
BPGGPGGGGGGGPGGGPGGHGGPB
BPGGPHHHHHHHPGGGPGGHGGPB
BPHHPGGGGGGGPGGGPGGHGGPB
BPGGPPPPPPPPPPPPPGGHGGPB
BPGGPGGGHGGGPGGGPGGHGGPB
BPPPPPPPPPPPPHHHPPPPPPPB
BPGGPGGGGGGGPGGGGGGPGGPB
BPPPPPPPPPPPPPPPPPPPHHPB
BPGGGGPGGHGGGGGGGGGPGGGB
BPPPPPPPPPPPPPPPPPPPPPPB
BBBBBBBBBBBBBBBBBBBBBBBB
M 1 1
C 10 1
C 16 6
C 2 9
1 14 5
2 9 7
3 12 5
4 1 9
5 22 11